#####################################
###S..C#.....#......###.......#...#.#
#.C.##...###...####.....#..##.#.##..#
#.#########.###....##.####.##.#.#.T##
#.............##.##.###..#T.....#...#
#####.#####.#.........C#.##########.#
#C........T.###.#.#.##.............E#
#####################################